
	| | | | | | | |
	| | | | | | | |
	| | | | | | | |
	| | | | | | | |
	| | | | | | | |
	| | | | | | | |
set->	-A-B-C-D-E-F-G-

It's your turn.


	| | | | | | | |
	| | | | | | | |
	| | | | | | | |
	| | | | | | | |
	| | | | | | | |
	| | | | | | | |
set->	-A-B-C-D-E-F-G-

It's your turn.


	| | | | | | | |
	| | | | | | | |
	| | | | | | | |
	| | | | | | | |
	| | | | | | | |
	| | | |y| | | |
set->	-A-B-C-D-E-F-G-

I selected: E.

	| | | | | | | |
	| | | | | | | |
	| | | | | | | |
	| | | | | | | |
	| | | | | | | |
	| | | |y|m| | |
set->	-A-B-C-D-E-F-G-

It's your turn.

