
	| | | | | | | |
	| | | | | | | |
	| | | | | | | |
	| | | | | | | |
	| | | | | | | |
	| | | | | | | |
选择->	-A-B-C-D-E-F-G-

轮到你了。


	| | | | | | | |
	| | | | | | | |
	| | | | | | | |
	| | | | | | | |
	| | | | | | | |
	| | | | | | | |
选择->	-A-B-C-D-E-F-G-

轮到你了。


	| | | | | | | |
	| | | | | | | |
	| | | | | | | |
	| | | | | | | |
	| | | | | | | |
	| | | |你| | | |
选择->	-A-B-C-D-E-F-G-

我选择了: E.

	| | | | | | | |
	| | | | | | | |
	| | | | | | | |
	| | | | | | | |
	| | | | | | | |
	| | | |你|我| | |
选择->	-A-B-C-D-E-F-G-

轮到你了。

